{
    "tile_definition": {
        "0": "PATH",
        "1": "WALL",
        "2": "OUTER",
        "3": "GOAL",
        "4": "ITEM"
    },
    "stages": [
        {
            "metadata": {
                "id": 1,
                "name": "Stage 1: Rhythm Beginnings",
                "bpm": 93,
                "music": "Resources/Sounds/stage1.wav",
                "width": 12,
                "height": 10,
                "spawn_point": {
                    "x": 2,
                    "y": 2
                },
                "items": [
                    {
                        "x": 6,
                        "y": 4,
                        "type": "darkness_down"
                    },
                    {
                        "x": 6,
                        "y": 3,
                        "type": "darkness_down"
                    },
                    {
                        "x": 9,
                        "y": 3,
                        "type": "time_scale_down",
                        "duration": 4.0
                    },
                    {
                        "x": 4,
                        "y": 4,
                        "type": "time_freeze",
                        "duration": 5.0
                    },
                    {
                        "x": 4,
                        "y": 2,
                        "type": "hp_up"
                    }
                ],
                "time_limit": 30,
                "angry_time": 10,
                "angry_time_scale": 1.3,
                "monster_count": 0,
                "intro_message": "정글을 탐험하던 중 몬스터가 나타났다!\n가능한 무시무시한 몬스터들을 피하면서 골인 지점에 도달하자.\n리듬에 맞춰 움직이는 것을 잊지 말도록!"
            },
            "layers": [
                [ 2, 2, 2, 2, 2, 2, 2, 2, 2, 2, 2, 2 ],
                [ 2, 1, 1, 1, 1, 1, 1, 1, 1, 1, 1, 2 ],
                [ 2, 1, 0, 0, 4, 1, 0, 0, 4, 0, 1, 2 ],
                [ 2, 1, 0, 1, 0, 1, 4, 1, 1, 0, 1, 2 ],
                [ 2, 1, 0, 1, 4, 0, 4, 1, 0, 0, 1, 2 ],
                [ 2, 1, 0, 1, 1, 1, 1, 1, 0, 1, 3, 2 ],
                [ 2, 1, 0, 0, 0, 1, 0, 0, 0, 1, 0, 2 ],
                [ 2, 1, 1, 1, 0, 1, 1, 1, 0, 1, 0, 2 ],
                [ 2, 1, 0, 0, 0, 0, 0, 1, 0, 0, 0, 2 ],
                [ 2, 2, 2, 2, 2, 2, 2, 2, 2, 2, 2, 2 ]
            ],
            "render_layers": [
                [ -1, -1, -1, -1, -1, -1, -1, -1, -1, -1, -1, -1 ],
                [ -1, 2, 2, 2, 2, 2, 2, 2, 2, 2, 2, -1 ],
                [ -1, 2, 0, 0, 0, 2, 0, 0, 0, 0, 2, -1 ],
                [ -1, 2, 0, 2, 1, 2, 0, 2, 2, 0, 2, -1 ],
                [ -1, 2, 0, 2, 1, 0, 0, 2, 0, 0, 2, -1 ],
                [ -1, 2, 0, 2, 2, 2, 2, 2, 0, 2, -1, -1 ],
                [ -1, 2, 0, 0, 0, 2, 0, 0, 0, 2, 0, -1 ],
                [ -1, 2, 2, 2, 0, 2, 2, 2, 0, 2, 0, -1 ],
                [ -1, 2, 0, 0, 0, 0, 0, 2, 0, 0, 0, -1 ],
                [ -1, -1, -1, -1, -1, -1, -1, -1, -1, -1, -1, -1 ]
            ]
        },
        {
            "metadata": {
                "id": 2,
                "name": "Stage 2: Double Tempo",
                "bpm": 121,
                "music": "Resources/Sounds/stage2.wav",
                "width": 25,
                "height": 11,
                "spawn_point": {
                    "x": 1,
                    "y": 1
                },
                "monster_spawns": [
                    {
                        "x": 8,
                        "y": 1
                    },
                    {
                        "x": 12,
                        "y": 3
                    },
                    {
                        "x": 13,
                        "y": 3
                    },
                    {
                        "x": 1,
                        "y": 5
                    },
                    {
                        "x": 2,
                        "y": 5
                    },
                    {
                        "x": 10,
                        "y": 5
                    }
                ],
                "items": [
                    {
                        "x": 6,
                        "y": 1,
                        "type": "invincibility"
                    },
                    {
                        "x": 11,
                        "y": 1,
                        "type": "invincibility"
                    },
                    {
                        "x": 1,
                        "y": 3,
                        "type": "invincibility"
                    },
                    {
                        "x": 2,
                        "y": 3,
                        "type": "invincibility"
                    },
                    {
                        "x": 13,
                        "y": 4,
                        "type": "invincibility"
                    },
                    {
                        "x": 13,
                        "y": 5,
                        "type": "invincibility"
                    }
                ],
                "time_limit": 60,
                "angry_time": 20,
                "angry_time_scale": 1.3,
                "monster_count": 6,
                "monster_types": [ "stone_golem", "stone_golem", "stone_golem", "stone_golem", "stone_golem", "stone_golem" ],
                "intro_message": "정글의 깊은 숲에 도달했다.\n더욱 무시무시한 몬스터가 나올 것만 같다..."
            },
            "layers": [
                [ 2, 2, 2, 2, 2, 2, 2, 2, 2, 2, 2, 2, 2, 2, 2, 2, 2, 2, 2, 2, 2, 2, 2, 2, 2 ],
                [ 2, 0, 0, 0, 0, 0, 0, 0, 0, 0, 0, 0, 0, 0, 0, 1, 1, 1, 0, 0, 0, 0, 0, 1, 2 ],
                [ 2, 0, 4, 1, 1, 1, 1, 1, 0, 0, 1, 1, 0, 0, 1, 1, 1, 1, 1, 1, 1, 1, 0, 0, 1 ],
                [ 2, 0, 0, 1, 0, 0, 0, 1, 4, 0, 1, 1, 0, 0, 0, 0, 0, 0, 0, 0, 0, 0, 0, 0, 1 ],
                [ 2, 0, 0, 1, 0, 0, 0, 1, 0, 0, 1, 1, 0, 0, 1, 1, 1, 1, 1, 1, 1, 1, 0, 0, 1 ],
                [ 2, 0, 0, 1, 1, 1, 1, 1, 0, 0, 0, 0, 0, 0, 1, 1, 0, 0, 0, 0, 3, 1, 0, 0, 1 ],
                [ 2, 0, 0, 0, 0, 0, 0, 1, 1, 1, 1, 0, 0, 0, 1, 1, 0, 0, 1, 1, 1, 1, 0, 0, 1 ],
                [ 2, 0, 0, 0, 0, 0, 0, 0, 0, 0, 0, 0, 0, 0, 0, 1, 0, 0, 1, 0, 0, 1, 0, 0, 1 ],
                [ 2, 0, 0, 1, 0, 0, 1, 1, 1, 1, 1, 0, 1, 0, 0, 0, 0, 0, 0, 0, 1, 0, 0, 0, 1 ],
                [ 2, 0, 0, 1, 0, 0, 0, 0, 0, 0, 1, 0, 1, 0, 0, 1, 1, 1, 1, 0, 0, 1, 0, 1, 1 ],
                [ 2, 2, 2, 2, 2, 2, 2, 2, 2, 2, 2, 2, 2, 2, 2, 2, 2, 2, 2, 2, 2, 2, 2, 2, 2 ]
            ],
            "render_layers": [
                [ -1, -1, -1, -1, -1, -1, -1, -1, -1, -1, -1, -1, -1, -1, -1, -1, -1, -1, -1, -1, -1, -1, -1, -1, -1 ],
                [ -1, 0, 0, 0, 0, 0, 0, 0, 0, 0, 0, 0, 0, 0, 0, 2, 2, 2, 0, 0, 0, 0, 0, 2, -1 ],
                [ -1, 0, 0, 2, 2, 2, 2, 2, 0, 0, 2, 2, 0, 0, 2, 2, 2, 2, 2, 2, 2, 2, 0, 0, 2 ],
                [ -1, 0, 0, 2, 0, 0, 0, 2, 0, 0, 2, 2, 0, 0, 0, 0, 0, 0, 0, 0, 0, 0, 0, 0, 2 ],
                [ -1, 0, 0, 2, 0, 0, 0, 2, 0, 0, 2, 2, 0, 0, 2, 2, 2, 2, 2, 2, 2, 2, 0, 0, 2 ],
                [ -1, 0, 0, 2, 2, 2, 2, 2, 0, 0, 0, 0, 0, 0, 2, 2, 0, 0, 0, 0, -1, 2, 0, 0, 2 ],
                [ -1, 0, 0, 0, 0, 0, 0, 2, 2, 2, 2, 0, 0, 0, 2, 2, 0, 0, 2, 2, 2, 2, 0, 0, 2 ],
                [ -1, 0, 0, 0, 0, 0, 0, 0, 0, 0, 0, 0, 0, 0, 0, 2, 0, 0, 2, 0, 0, 2, 0, 0, 2 ],
                [ -1, 0, 0, 2, 0, 0, 2, 2, 2, 2, 2, 0, 2, 0, 0, 0, 0, 0, 0, 0, 2, 0, 0, 0, 2 ],
                [ -1, 0, 0, 2, 0, 0, 0, 0, 0, 0, 2, 0, 2, 0, 0, 2, 2, 2, 2, 0, 0, 2, 0, 2, 2 ],
                [ -1, -1, -1, -1, -1, -1, -1, -1, -1, -1, -1, -1, -1, -1, -1, -1, -1, -1, -1, -1, -1, -1, -1, -1, -1 ]
            ]
        },
        {
            "metadata": {
                "id": 3,
                "name": "Stage 3: Jungle Echo Maze",
                "bpm": 160,
                "music": "Resources/Sounds/stage4.wav",
                "width": 77,
                "height": 24,
                "spawn_point": {
                    "x": 8,
                    "y": 2
                },
                "items": [
                    {
                        "x": 18,
                        "y": 2,
                        "type": "darkness_down"
                    },
                    {
                        "x": 18,
                        "y": 4,
                        "type": "time_freeze",
                        "duration": 5.0
                    },
                    {
                        "x": 13,
                        "y": 7,
                        "type": "darkness_down"
                    },
                    {
                        "x": 13,
                        "y": 12,
                        "type": "time_freeze",
                        "duration": 5.0
                    },
                    {
                        "x": 7,
                        "y": 13,
                        "type": "time_freeze",
                        "duration": 5.0
                    },
                    {
                        "x": 24,
                        "y": 17,
                        "type": "time_freeze",
                        "duration": 5.0
                    },
                    {
                        "x": 24,
                        "y": 12,
                        "type": "invincibility"
                    },
                    {
                        "x": 32,
                        "y": 12,
                        "type": "darkness_up"
                    },
                    {
                        "x": 35,
                        "y": 11,
                        "type": "darkness_up"
                    },
                    {
                        "x": 31,
                        "y": 7,
                        "type": "darkness_down"
                    },
                    {
                        "x": 43,
                        "y": 7,
                        "type": "darkness_up"
                    },
                    {
                        "x": 53,
                        "y": 10,
                        "type": "invincibility"
                    },
                    {
                        "x": 23,
                        "y": 6,
                        "type": "invincibility"
                    },
                    {
                        "x": 35,
                        "y": 11,
                        "type": "time_scale_down",
                        "duration": 8.0
                    },
                    {
                        "x": 53,
                        "y": 10,
                        "type": "darkness_down"
                    },
                    {
                        "x": 60,
                        "y": 20,
                        "type": "darkness_down"
                    }
                ],
                "time_limit": 80,
                "angry_time": 25,
                "angry_time_scale": 1.4,
                "monster_count": 5,
                "monster_types": [ "stone_golem", "fire_golem" ],
                "intro_message": ""
            },
            "layers": [
                [ 2, 2, 2, 2, 2, 2, 2, 2, 2, 2, 2, 2, 2, 2, 2, 2, 2, 2, 2, 2, 2, 2, 2, 2, 2, 2, 2, 2, 2, 2, 2, 2, 2, 2, 2, 2, 2, 2, 2, 2, 2, 2, 2, 2, 2, 2, 2, 2, 2, 2, 2, 2, 2, 2, 2, 2, 2, 2, 2, 2, 2, 2, 2, 2, 2, 2, 2, 2, 2, 2, 2, 2, 2, 2, 2, 2, 2 ],
                [ 2, 2, 2, 2, 2, 2, 2, 1, 1, 1, 1, 1, 1, 1, 1, 1, 1, 1, 1, 1, 1, 1, 1, 1, 1, 2, 2, 2, 2, 2, 1, 1, 1, 1, 1, 1, 1, 1, 1, 1, 1, 1, 1, 1, 1, 1, 1, 1, 1, 1, 1, 1, 1, 1, 1, 1, 1, 1, 1, 1, 1, 1, 1, 1, 1, 1, 1, 1, 1, 1, 1, 2, 2, 2, 2, 2, 2 ],
                [ 2, 2, 2, 2, 2, 2, 2, 1, 0, 0, 0, 0, 0, 0, 0, 0, 0, 0, 4, 0, 0, 0, 0, 0, 1, 2, 2, 2, 2, 2, 1, 0, 0, 0, 0, 0, 0, 0, 0, 0, 0, 0, 0, 0, 0, 0, 0, 0, 0, 0, 0, 0, 0, 0, 0, 0, 0, 0, 0, 0, 0, 0, 0, 0, 0, 0, 0, 0, 0, 0, 1, 2, 2, 2, 2, 2, 2 ],
                [ 2, 2, 2, 2, 2, 2, 2, 1, 1, 1, 1, 1, 1, 1, 1, 1, 0, 0, 0, 0, 1, 1, 1, 1, 1, 2, 2, 2, 2, 2, 1, 1, 1, 1, 1, 1, 1, 1, 1, 1, 1, 1, 1, 1, 1, 1, 0, 0, 0, 1, 1, 1, 1, 1, 1, 1, 1, 1, 1, 1, 1, 1, 1, 1, 1, 1, 1, 0, 0, 0, 1, 2, 2, 2, 2, 2, 2 ],
                [ 2, 2, 2, 2, 2, 2, 2, 2, 2, 2, 2, 2, 2, 2, 2, 1, 0, 0, 0, 0, 1, 2, 2, 2, 2, 2, 2, 2, 2, 2, 2, 2, 2, 2, 2, 2, 2, 2, 2, 2, 2, 2, 2, 2, 2, 1, 0, 0, 0, 1, 2, 2, 2, 2, 2, 2, 2, 2, 2, 2, 2, 2, 2, 2, 2, 2, 1, 0, 0, 0, 1, 2, 2, 2, 2, 2, 2 ],
                [ 2, 2, 2, 2, 2, 1, 1, 1, 1, 1, 1, 1, 1, 1, 1, 1, 0, 0, 0, 0, 1, 1, 1, 1, 1, 1, 1, 1, 2, 2, 2, 2, 2, 1, 1, 1, 1, 1, 1, 2, 2, 2, 2, 2, 2, 1, 0, 0, 0, 1, 1, 1, 1, 1, 1, 1, 1, 1, 1, 1, 1, 2, 2, 2, 2, 2, 1, 0, 0, 0, 1, 2, 2, 2, 2, 2, 2 ],
                [ 2, 2, 2, 2, 2, 1, 0, 0, 0, 0, 0, 0, 0, 0, 0, 0, 0, 0, 0, 0, 0, 0, 0, 4, 0, 0, 0, 1, 2, 2, 1, 1, 1, 1, 0, 0, 0, 1, 1, 1, 1, 1, 1, 1, 1, 1, 0, 0, 0, 0, 0, 0, 0, 0, 0, 0, 0, 0, 0, 0, 1, 2, 2, 1, 1, 1, 1, 0, 0, 0, 1, 2, 2, 2, 2, 2, 2 ],
                [ 2, 2, 2, 2, 2, 1, 0, 0, 0, 0, 0, 0, 0, 0, 0, 0, 0, 0, 0, 0, 0, 0, 0, 0, 0, 0, 0, 1, 2, 2, 1, 0, 0, 0, 0, 0, 0, 0, 0, 0, 0, 0, 0, 0, 0, 0, 0, 1, 1, 1, 1, 1, 1, 1, 1, 1, 1, 0, 0, 0, 1, 2, 2, 1, 0, 0, 0, 0, 0, 0, 1, 2, 2, 2, 2, 2, 2 ],
                [ 2, 2, 2, 2, 2, 1, 1, 1, 1, 1, 1, 1, 0, 0, 0, 0, 1, 1, 1, 1, 1, 0, 0, 0, 0, 0, 0, 1, 2, 2, 1, 1, 1, 1, 0, 0, 0, 1, 1, 1, 1, 1, 1, 1, 1, 1, 1, 1, 2, 2, 2, 2, 2, 2, 2, 2, 1, 0, 0, 0, 1, 2, 2, 1, 1, 1, 1, 1, 1, 1, 1, 2, 2, 2, 2, 2, 2 ],
                [ 2, 2, 2, 2, 2, 2, 2, 2, 2, 2, 2, 1, 0, 0, 0, 0, 1, 2, 2, 2, 1, 0, 0, 0, 0, 0, 0, 1, 2, 2, 2, 2, 2, 1, 0, 0, 0, 1, 2, 2, 2, 2, 2, 2, 2, 2, 2, 2, 2, 2, 2, 1, 1, 1, 1, 1, 1, 0, 0, 0, 1, 2, 2, 2, 2, 2, 2, 2, 2, 2, 2, 2, 2, 2, 2, 2, 2 ],
                [ 2, 2, 2, 2, 2, 2, 2, 2, 2, 2, 2, 1, 0, 0, 0, 0, 1, 2, 2, 2, 1, 0, 0, 0, 0, 0, 0, 1, 2, 2, 2, 2, 2, 1, 0, 0, 0, 1, 2, 2, 1, 1, 1, 1, 1, 1, 1, 1, 1, 1, 1, 1, 0, 4, 0, 0, 0, 0, 0, 0, 1, 2, 2, 2, 2, 2, 2, 2, 2, 2, 2, 2, 2, 2, 2, 2, 2 ],
                [ 2, 2, 2, 2, 2, 1, 1, 1, 1, 1, 1, 1, 0, 0, 0, 0, 1, 2, 2, 2, 1, 0, 0, 0, 0, 0, 0, 1, 1, 1, 1, 1, 1, 1, 0, 4, 0, 1, 2, 2, 1, 0, 0, 0, 0, 0, 0, 0, 0, 0, 0, 0, 0, 0, 0, 0, 1, 1, 1, 1, 1, 2, 2, 2, 2, 2, 2, 2, 2, 2, 2, 2, 2, 2, 2, 2, 2 ],
                [ 2, 2, 2, 2, 2, 1, 0, 0, 0, 0, 0, 0, 0, 0, 0, 0, 1, 2, 2, 2, 1, 0, 0, 0, 0, 0, 0, 0, 0, 0, 0, 0, 0, 0, 0, 0, 0, 1, 2, 2, 1, 0, 0, 0, 0, 0, 0, 0, 0, 0, 0, 0, 0, 0, 0, 0, 1, 2, 2, 2, 2, 2, 2, 2, 2, 2, 2, 2, 2, 2, 2, 2, 2, 2, 2, 2, 2 ],
                [ 2, 2, 2, 2, 2, 1, 0, 0, 0, 0, 0, 0, 0, 0, 0, 0, 1, 2, 2, 2, 1, 0, 0, 0, 0, 0, 0, 1, 1, 1, 1, 1, 1, 1, 1, 1, 1, 1, 2, 2, 1, 0, 0, 0, 0, 1, 1, 1, 1, 1, 1, 1, 0, 0, 0, 0, 1, 1, 1, 1, 1, 1, 1, 1, 1, 1, 1, 1, 1, 1, 1, 1, 2, 2, 2, 2, 2 ],
                [ 2, 2, 2, 2, 2, 1, 0, 0, 0, 0, 0, 0, 0, 0, 0, 0, 1, 2, 2, 2, 1, 0, 0, 0, 0, 0, 0, 1, 2, 2, 2, 2, 2, 2, 2, 2, 2, 2, 2, 2, 1, 0, 0, 0, 0, 1, 2, 2, 2, 2, 2, 1, 0, 0, 0, 0, 0, 0, 0, 0, 0, 0, 0, 0, 0, 0, 0, 0, 0, 0, 0, 1, 2, 2, 2, 2, 2 ],
                [ 2, 2, 2, 2, 2, 1, 1, 1, 1, 1, 1, 1, 1, 1, 1, 1, 1, 2, 2, 2, 1, 0, 0, 0, 0, 0, 0, 1, 2, 2, 2, 2, 2, 2, 2, 2, 2, 2, 2, 2, 1, 0, 0, 0, 0, 1, 2, 2, 2, 2, 2, 1, 0, 0, 0, 0, 0, 0, 0, 0, 0, 0, 0, 0, 0, 0, 0, 0, 0, 0, 0, 1, 2, 2, 2, 2, 2 ],
                [ 2, 2, 2, 2, 2, 2, 2, 2, 2, 2, 2, 2, 2, 2, 2, 2, 2, 2, 2, 2, 1, 0, 0, 0, 0, 0, 0, 1, 2, 2, 2, 2, 2, 2, 2, 2, 2, 2, 2, 2, 1, 0, 0, 0, 0, 1, 2, 2, 2, 2, 2, 1, 1, 1, 1, 1, 1, 1, 1, 1, 1, 1, 1, 1, 1, 1, 1, 0, 0, 0, 0, 1, 2, 2, 2, 2, 2 ],
                [ 2, 2, 2, 2, 2, 2, 2, 2, 2, 2, 1, 1, 1, 1, 1, 1, 1, 1, 1, 1, 1, 0, 0, 0, 0, 0, 0, 1, 1, 1, 1, 1, 1, 1, 1, 1, 1, 1, 2, 2, 1, 0, 0, 0, 0, 1, 2, 2, 2, 2, 2, 2, 2, 2, 2, 2, 2, 2, 2, 2, 2, 2, 2, 2, 2, 2, 1, 0, 0, 0, 0, 1, 2, 2, 2, 2, 2 ],
                [ 2, 2, 2, 2, 2, 2, 2, 2, 2, 2, 1, 0, 0, 0, 0, 0, 0, 0, 0, 0, 0, 0, 0, 0, 0, 0, 0, 0, 0, 0, 0, 0, 0, 0, 0, 0, 0, 1, 2, 2, 1, 1, 1, 1, 1, 1, 2, 2, 2, 2, 2, 2, 2, 2, 2, 2, 2, 2, 2, 2, 2, 2, 2, 2, 2, 2, 1, 0, 0, 0, 0, 1, 2, 2, 2, 2, 2 ],
                [ 2, 2, 2, 2, 2, 2, 2, 2, 2, 2, 1, 0, 0, 0, 0, 0, 0, 0, 0, 0, 0, 0, 0, 0, 0, 0, 0, 0, 0, 0, 0, 0, 0, 0, 0, 0, 0, 1, 2, 2, 2, 2, 2, 2, 2, 2, 2, 2, 1, 1, 1, 1, 1, 1, 1, 1, 1, 1, 1, 1, 1, 1, 1, 1, 1, 1, 1, 0, 0, 0, 0, 1, 2, 2, 2, 2, 2 ],
                [ 2, 2, 2, 2, 2, 2, 2, 2, 2, 2, 1, 0, 0, 0, 0, 0, 0, 0, 0, 0, 0, 0, 0, 0, 0, 0, 0, 0, 0, 0, 0, 0, 0, 0, 0, 0, 0, 1, 2, 2, 2, 2, 2, 2, 2, 2, 2, 2, 1, 0, 0, 0, 0, 0, 0, 0, 0, 0, 0, 0, 4, 0, 0, 0, 0, 0, 0, 0, 0, 0, 0, 1, 2, 2, 2, 2, 2 ],
                [ 2, 2, 2, 2, 2, 2, 2, 2, 2, 2, 1, 0, 0, 0, 0, 0, 0, 0, 0, 0, 0, 0, 0, 0, 0, 0, 0, 0, 0, 0, 0, 0, 0, 0, 0, 0, 0, 1, 2, 2, 2, 2, 2, 2, 2, 2, 2, 2, 1, 3, 0, 0, 0, 0, 0, 0, 0, 0, 0, 0, 0, 0, 0, 0, 0, 0, 0, 0, 0, 0, 0, 1, 2, 2, 2, 2, 2 ],
                [ 2, 2, 2, 2, 2, 2, 2, 2, 2, 2, 1, 1, 1, 1, 1, 1, 1, 1, 1, 1, 1, 1, 1, 1, 1, 1, 1, 1, 1, 1, 1, 1, 1, 1, 1, 1, 1, 1, 2, 2, 2, 2, 2, 2, 2, 2, 2, 2, 1, 1, 1, 1, 1, 1, 1, 1, 1, 1, 1, 1, 1, 1, 1, 1, 1, 1, 1, 1, 1, 1, 1, 1, 2, 2, 2, 2, 2 ],
                [ 2, 2, 2, 2, 2, 2, 2, 2, 2, 2, 2, 2, 2, 2, 2, 2, 2, 2, 2, 2, 2, 2, 2, 2, 2, 2, 2, 2, 2, 2, 2, 2, 2, 2, 2, 2, 2, 2, 2, 2, 2, 2, 2, 2, 2, 2, 2, 2, 2, 2, 2, 2, 2, 2, 2, 2, 2, 2, 2, 2, 2, 2, 2, 2, 2, 2, 2, 2, 2, 2, 2, 2, 2, 2, 2, 2, 2 ]
            ],
            "render_layers": [
                [ -1, -1, -1, -1, -1, -1, -1, -1, -1, -1, -1, -1, -1, -1, -1, -1, -1, -1, -1, -1, -1, -1, -1, -1, -1, -1, -1, -1, -1, -1, -1, -1, -1, -1, -1, -1, -1, -1, -1, -1, -1, -1, -1, -1, -1, -1, -1, -1, -1, -1, -1, -1, -1, -1, -1, -1, -1, -1, -1, -1, -1, -1, -1, -1, -1, -1, -1, -1, -1, -1, -1, -1, -1, -1, -1, -1, -1 ],
                [ -1, -1, -1, -1, -1, -1, -1, 2, 2, 2, 2, 2, 2, 2, 2, 2, 2, 2, 2, 2, 2, 2, 2, 2, 2, -1, -1, -1, -1, -1, 2, 2, 2, 2, 2, 2, 2, 2, 2, 2, 2, 2, 2, 2, 2, 2, 2, 2, 2, 2, 2, 2, 2, 2, 2, 2, 2, 2, 2, 2, 2, 2, 2, 2, 2, 2, 2, 2, 2, 2, 2, -1, -1, -1, -1, -1, -1 ],
                [ -1, -1, -1, -1, -1, -1, -1, 2, 0, 0, 0, 0, 0, 0, 0, 0, 0, 0, 0, 0, 0, 0, 0, 0, 2, -1, -1, -1, -1, -1, 2, 0, 0, 0, 0, 0, 0, 0, 0, 0, 0, 0, 0, 0, 0, 0, 0, 0, 0, 0, 0, 0, 0, 0, 0, 0, 0, 0, 0, 0, 0, 0, 0, 0, 0, 0, 0, 0, 0, 0, 2, -1, -1, -1, -1, -1, -1 ],
                [ -1, -1, -1, -1, -1, -1, -1, 2, 2, 2, 2, 2, 2, 2, 2, 2, 0, 0, 0, 0, 2, 2, 2, 2, 2, -1, -1, -1, -1, -1, 2, 2, 2, 2, 2, 2, 2, 2, 2, 2, 2, 2, 2, 2, 2, 2, 0, 0, 0, 2, 2, 2, 2, 2, 2, 2, 2, 2, 2, 2, 2, 2, 2, 2, 2, 2, 2, 0, 0, 0, 2, -1, -1, -1, -1, -1, -1 ],
                [ -1, -1, -1, -1, -1, -1, -1, -1, -1, -1, -1, -1, -1, -1, -1, 2, 0, 0, 0, 0, 2, -1, -1, -1, -1, -1, -1, -1, -1, -1, -1, -1, -1, -1, -1, -1, -1, -1, -1, -1, -1, -1, -1, -1, -1, 2, 0, 0, 0, 2, -1, -1, -1, -1, -1, -1, -1, -1, -1, -1, -1, -1, -1, -1, -1, -1, 2, 0, 0, 0, 2, -1, -1, -1, -1, -1, -1 ],
                [ -1, -1, -1, -1, -1, 2, 2, 2, 2, 2, 2, 2, 2, 2, 2, 2, 0, 0, 0, 0, 2, 2, 2, 2, 2, 2, 2, 2, -1, -1, -1, -1, -1, 2, 2, 2, 2, 2, 2, -1, -1, -1, -1, -1, -1, 2, 0, 0, 0, 2, 2, 2, 2, 2, 2, 2, 2, 2, 2, 2, 2, -1, -1, -1, -1, -1, 2, 0, 0, 0, 2, -1, -1, -1, -1, -1, -1 ],
                [ -1, -1, -1, -1, -1, 2, 0, 0, 0, 0, 0, 0, 0, 0, 0, 0, 0, 0, 0, 0, 0, 0, 0, 0, 0, 0, 0, 2, -1, -1, 2, 2, 2, 2, 0, 0, 0, 2, 2, 2, 2, 2, 2, 2, 2, 2, 0, 0, 0, 0, 0, 0, 0, 0, 0, 0, 0, 0, 0, 0, 2, -1, -1, 2, 2, 2, 2, 0, 0, 0, 2, -1, -1, -1, -1, -1, -1 ],
                [ -1, -1, -1, -1, -1, 2, 0, 0, 0, 0, 0, 0, 0, 0, 0, 0, 0, 0, 0, 0, 0, 0, 0, 0, 0, 0, 0, 2, -1, -1, 2, 0, 0, 0, 0, 0, 0, 0, 0, 0, 0, 0, 0, 0, 0, 0, 0, 2, 2, 2, 2, 2, 2, 2, 2, 2, 2, 0, 0, 0, 2, -1, -1, 2, 0, 0, 0, 0, 0, 0, 2, -1, -1, -1, -1, -1, -1 ],
                [ -1, -1, -1, -1, -1, 2, 2, 2, 2, 2, 2, 2, 0, 0, 0, 0, 2, 2, 2, 2, 2, 0, 0, 0, 0, 0, 0, 2, -1, -1, 2, 2, 2, 2, 0, 0, 0, 2, 2, 2, 2, 2, 2, 2, 2, 2, 2, 2, -1, -1, -1, -1, -1, -1, -1, -1, 2, 0, 0, 0, 2, -1, -1, 2, 2, 2, 2, 2, 2, 2, 2, -1, -1, -1, -1, -1, -1 ],
                [ -1, -1, -1, -1, -1, -1, -1, -1, -1, -1, -1, 2, 0, 0, 0, 0, 2, -1, -1, -1, 2, 0, 0, 0, 0, 0, 0, 2, -1, -1, -1, -1, -1, 2, 0, 0, 0, 2, -1, -1, -1, -1, -1, -1, -1, -1, -1, -1, -1, -1, -1, 2, 2, 2, 2, 2, 2, 0, 0, 0, 2, -1, -1, -1, -1, -1, -1, -1, -1, -1, -1, -1, -1, -1, -1, -1, -1 ],
                [ -1, -1, -1, -1, -1, -1, -1, -1, -1, -1, -1, 2, 0, 0, 0, 0, 2, -1, -1, -1, 2, 0, 0, 0, 0, 0, 0, 2, -1, -1, -1, -1, -1, 2, 0, 0, 0, 2, -1, -1, 2, 2, 2, 2, 2, 2, 2, 2, 2, 2, 2, 2, 0, 0, 0, 0, 0, 0, 0, 0, 2, -1, -1, -1, -1, -1, -1, -1, -1, -1, -1, -1, -1, -1, -1, -1, -1 ],
                [ -1, -1, -1, -1, -1, 2, 2, 2, 2, 2, 2, 2, 0, 0, 0, 0, 2, -1, -1, -1, 2, 0, 0, 0, 0, 0, 0, 2, 2, 2, 2, 2, 2, 2, 0, 0, 0, 2, -1, -1, 2, 0, 0, 0, 0, 0, 0, 0, 0, 0, 0, 0, 0, 0, 0, 0, 2, 2, 2, 2, 2, -1, -1, -1, -1, -1, -1, -1, -1, -1, -1, -1, -1, -1, -1, -1, -1 ],
                [ -1, -1, -1, -1, -1, 2, 0, 0, 0, 0, 0, 0, 0, 0, 0, 0, 2, -1, -1, -1, 2, 0, 0, 0, 0, 0, 0, 0, 0, 0, 0, 0, 0, 0, 0, 0, 0, 2, -1, -1, 2, 0, 0, 0, 0, 0, 0, 0, 0, 0, 0, 0, 0, 0, 0, 0, 2, -1, -1, -1, -1, -1, -1, -1, -1, -1, -1, -1, -1, -1, -1, -1, -1, -1, -1, -1, -1 ],
                [ -1, -1, -1, -1, -1, 2, 0, 0, 0, 0, 0, 0, 0, 0, 0, 0, 2, -1, -1, -1, 2, 0, 0, 0, 0, 0, 0, 2, 2, 2, 2, 2, 2, 2, 2, 2, 2, 2, -1, -1, 2, 0, 0, 0, 0, 2, 2, 2, 2, 2, 2, 2, 0, 0, 0, 0, 2, 2, 2, 2, 2, 2, 2, 2, 2, 2, 2, 2, 2, 2, 2, 2, -1, -1, -1, -1, -1 ],
                [ -1, -1, -1, -1, -1, 2, 0, 0, 0, 0, 0, 0, 0, 0, 0, 0, 2, -1, -1, -1, 2, 0, 0, 0, 0, 0, 0, 2, -1, -1, -1, -1, -1, -1, -1, -1, -1, -1, -1, -1, 2, 0, 0, 0, 0, 2, -1, -1, -1, -1, -1, 2, 0, 0, 0, 0, 0, 0, 0, 0, 0, 0, 0, 0, 0, 0, 0, 0, 0, 0, 0, 2, -1, -1, -1, -1, -1 ],
                [ -1, -1, -1, -1, -1, 2, 2, 2, 2, 2, 2, 2, 2, 2, 2, 2, 2, -1, -1, -1, 2, 0, 0, 0, 0, 0, 0, 2, -1, -1, -1, -1, -1, -1, -1, -1, -1, -1, -1, -1, 2, 0, 0, 0, 0, 2, -1, -1, -1, -1, -1, 2, 0, 0, 0, 0, 0, 0, 0, 0, 0, 0, 0, 0, 0, 0, 0, 0, 0, 0, 0, 2, -1, -1, -1, -1, -1 ],
                [ -1, -1, -1, -1, -1, -1, -1, -1, -1, -1, -1, -1, -1, -1, -1, -1, -1, -1, -1, -1, 2, 0, 0, 0, 0, 0, 0, 2, -1, -1, -1, -1, -1, -1, -1, -1, -1, -1, -1, -1, 2, 0, 0, 0, 0, 2, -1, -1, -1, -1, -1, 2, 2, 2, 2, 2, 2, 2, 2, 2, 2, 2, 2, 2, 2, 2, 2, 0, 0, 0, 0, 2, -1, -1, -1, -1, -1 ],
                [ -1, -1, -1, -1, -1, -1, -1, -1, -1, -1, 2, 2, 2, 2, 2, 2, 2, 2, 2, 2, 2, 0, 0, 0, 0, 0, 0, 2, 2, 2, 2, 2, 2, 2, 2, 2, 2, 2, -1, -1, 2, 0, 0, 0, 0, 2, -1, -1, -1, -1, -1, -1, -1, -1, -1, -1, -1, -1, -1, -1, -1, -1, -1, -1, -1, -1, 2, 0, 0, 0, 0, 2, -1, -1, -1, -1, -1 ],
                [ -1, -1, -1, -1, -1, -1, -1, -1, -1, -1, 2, 0, 0, 0, 0, 0, 0, 0, 0, 0, 0, 0, 0, 0, 0, 0, 0, 0, 0, 0, 0, 0, 0, 0, 0, 0, 0, 2, -1, -1, 2, 2, 2, 2, 2, 2, -1, -1, -1, -1, -1, -1, -1, -1, -1, -1, -1, -1, -1, -1, -1, -1, -1, -1, -1, -1, 2, 0, 0, 0, 0, 2, -1, -1, -1, -1, -1 ],
                [ -1, -1, -1, -1, -1, -1, -1, -1, -1, -1, 2, 0, 0, 0, 0, 0, 0, 0, 0, 0, 0, 0, 0, 0, 0, 0, 0, 0, 0, 0, 0, 0, 0, 0, 0, 0, 0, 2, -1, -1, -1, -1, -1, -1, -1, -1, -1, -1, 2, 2, 2, 2, 2, 2, 2, 2, 2, 2, 2, 2, 2, 2, 2, 2, 2, 2, 2, 0, 0, 0, 0, 2, -1, -1, -1, -1, -1 ],
                [ -1, -1, -1, -1, -1, -1, -1, -1, -1, -1, 2, 0, 0, 0, 0, 0, 0, 0, 0, 0, 0, 0, 0, 0, 0, 0, 0, 0, 0, 0, 0, 0, 0, 0, 0, 0, 0, 2, -1, -1, -1, -1, -1, -1, -1, -1, -1, -1, 2, 0, 0, 0, 0, 0, 0, 0, 0, 0, 0, 0, 0, 0, 0, 0, 0, 0, 0, 0, 0, 0, 0, 2, -1, -1, -1, -1, -1 ],
                [ -1, -1, -1, -1, -1, -1, -1, -1, -1, -1, 2, 0, 0, 0, 0, 0, 0, 0, 0, 0, 0, 0, 0, 0, 0, 0, 0, 0, 0, 0, 0, 0, 0, 0, 0, 0, 0, 2, -1, -1, -1, -1, -1, -1, -1, -1, -1, -1, 2, -1, 0, 0, 0, 0, 0, 0, 0, 0, 0, 0, 0, 0, 0, 0, 0, 0, 0, 0, 0, 0, 0, 2, -1, -1, -1, -1, -1 ],
                [ -1, -1, -1, -1, -1, -1, -1, -1, -1, -1, 2, 2, 2, 2, 2, 2, 2, 2, 2, 2, 2, 2, 2, 2, 2, 2, 2, 2, 2, 2, 2, 2, 2, 2, 2, 2, 2, 2, -1, -1, -1, -1, -1, -1, -1, -1, -1, -1, 2, 2, 2, 2, 2, 2, 2, 2, 2, 2, 2, 2, 2, 2, 2, 2, 2, 2, 2, 2, 2, 2, 2, 2, -1, -1, -1, -1, -1 ],
                [ -1, -1, -1, -1, -1, -1, -1, -1, -1, -1, -1, -1, -1, -1, -1, -1, -1, -1, -1, -1, -1, -1, -1, -1, -1, -1, -1, -1, -1, -1, -1, -1, -1, -1, -1, -1, -1, -1, -1, -1, -1, -1, -1, -1, -1, -1, -1, -1, -1, -1, -1, -1, -1, -1, -1, -1, -1, -1, -1, -1, -1, -1, -1, -1, -1, -1, -1, -1, -1, -1, -1, -1, -1, -1, -1, -1, -1 ]
            ]
        }
    ]
}