{
    "tile_definition": {
        "0": "PATH",
        "1": "WALL",
        "2": "OUTER",
        "3": "GOAL"
    },
    "stages": [
        {
            "metadata": {
                "id": 1,
                "name": "Stage 1: Rhythm Beginnings",
                "bpm": 93,
                "music": "Resources/Sounds/stage1.wav",
                "width": 10,
                "height": 8,
                "spawn_point": {
                    "x": 2,
                    "y": 2
                },
                "time_limit": 30
            },
            "layers": [
                [ 2, 2, 2, 2, 2, 2, 2, 2, 2, 2 ],
                [ 2, 1, 1, 1, 1, 1, 1, 1, 1, 2 ],
                [ 2, 1, 0, 0, 0, 1, 0, 0, 1, 2 ],
                [ 2, 1, 0, 1, 0, 1, 0, 1, 1, 2 ],
                [ 2, 1, 0, 1, 0, 0, 0, 0, 1, 2 ],
                [ 2, 1, 0, 1, 1, 1, 1, 3, 1, 2 ],
                [ 2, 1, 1, 1, 1, 1, 1, 1, 1, 2 ],
                [ 2, 2, 2, 2, 2, 2, 2, 2, 2, 2 ]
            ]
        },
        {
            "metadata": {
                "id": 2,
                "name": "Stage 2: Double Tempo",
                "bpm": 121,
                "music": "Resources/Sounds/stage2.wav",
                "width": 10,
                "height": 8,
                "spawn_point": {
                    "x": 1,
                    "y": 1
                },
                "monster_spawns": [
                    {
                        "x": 7,
                        "y": 3
                    }
                ],
                "time_limit": 45
            },
            "layers": [
                [ 2, 2, 2, 2, 2, 2, 2, 2, 2, 2 ],
                [ 2, 0, 0, 0, 0, 0, 0, 0, 1, 2 ],
                [ 2, 1, 1, 1, 1, 1, 1, 0, 1, 2 ],
                [ 2, 1, 0, 0, 0, 0, 0, 0, 1, 2 ],
                [ 2, 1, 0, 1, 1, 1, 1, 1, 1, 2 ],
                [ 2, 1, 0, 0, 0, 0, 0, 3, 1, 2 ],
                [ 2, 1, 1, 1, 1, 1, 1, 1, 1, 2 ],
                [ 2, 2, 2, 2, 2, 2, 2, 2, 2, 2 ]
            ]
        },
        {
            "metadata": {
                "id": 3,
                "name": "Stage 3: Jungle Labyrinth",
                "bpm": 93,
                "music": "Resources/Sounds/stage1.wav",
                "width": 12,
                "height": 10,
                "spawn_point": {
                    "x": 2,
                    "y": 2
                },
                "time_limit": 60
            },

            "layers": [
                [ 2, 2, 2, 2, 2, 2, 2, 2, 2, 2, 2, 2 ],
                [ 2, 1, 1, 1, 1, 1, 1, 1, 1, 1, 1, 2 ],
                [ 2, 1, 0, 0, 0, 1, 0, 0, 0, 0, 1, 2 ],
                [ 2, 1, 0, 1, 0, 1, 0, 1, 1, 0, 1, 2 ],
                [ 2, 1, 0, 1, 0, 0, 0, 1, 0, 0, 1, 2 ],
                [ 2, 1, 0, 1, 1, 1, 0, 1, 0, 1, 1, 2 ],
                [ 2, 1, 0, 0, 0, 1, 0, 0, 0, 0, 1, 2 ],
                [ 2, 1, 1, 1, 0, 1, 1, 1, 1, 0, 1, 2 ],
                [ 2, 1, 0, 0, 0, 0, 0, 0, 1, 3, 1, 2 ],
                [ 2, 2, 2, 2, 2, 2, 2, 2, 2, 2, 2, 2 ]
            ]
        },
        {
            "metadata": {
                "id": 4,
                "name": "Stage 4: Jungle Echo Maze",
                "bpm": 121,
                "music": "Resources/Sounds/stage2.wav",
                "width": 40,
                "height": 27,
                "spawn_point": {
                    "x": 2,
                    "y": 2
                },
                "time_limit": 120
            },

            "layers": [
                [ 2, 2, 2, 2, 2, 2, 2, 2, 2, 2, 2, 2, 2, 2, 2, 2, 2, 2, 2, 2, 2, 2, 2, 2, 2, 2, 2, 2, 2, 2, 2, 2, 2, 2, 2, 2, 2, 2, 2, 2 ],
                [ 2, 1, 1, 1, 1, 1, 1, 1, 1, 1, 1, 1, 1, 1, 1, 1, 1, 1, 1, 1, 1, 1, 1, 1, 1, 1, 1, 1, 1, 1, 1, 1, 1, 1, 1, 1, 1, 1, 1, 2 ],
                [ 2, 1, 0, 0, 0, 0, 1, 0, 0, 0, 0, 0, 1, 0, 0, 0, 0, 0, 1, 0, 0, 0, 0, 0, 1, 0, 0, 0, 0, 0, 1, 0, 0, 0, 0, 0, 1, 0, 1, 2 ],
                [ 2, 1, 0, 1, 1, 0, 1, 0, 1, 1, 1, 0, 1, 0, 1, 1, 1, 0, 1, 0, 1, 1, 1, 0, 1, 0, 1, 1, 1, 0, 1, 0, 1, 1, 1, 0, 1, 0, 1, 2 ],
                [ 2, 1, 0, 1, 0, 0, 0, 0, 1, 0, 0, 0, 0, 0, 1, 0, 0, 0, 0, 0, 1, 0, 0, 0, 0, 0, 1, 0, 0, 0, 0, 0, 1, 0, 0, 0, 0, 0, 1, 2 ],
                [ 2, 1, 0, 1, 0, 1, 1, 1, 1, 0, 1, 1, 1, 0, 1, 0, 1, 1, 1, 0, 1, 0, 1, 1, 1, 0, 1, 0, 1, 1, 1, 0, 1, 0, 1, 1, 1, 0, 1, 2 ],
                [ 2, 1, 0, 1, 0, 1, 0, 0, 0, 0, 0, 0, 1, 0, 0, 0, 1, 0, 0, 0, 0, 0, 1, 0, 0, 0, 1, 0, 0, 0, 1, 0, 0, 0, 1, 0, 0, 0, 1, 2 ],
                [ 2, 1, 0, 1, 0, 1, 0, 1, 1, 1, 1, 0, 1, 1, 1, 0, 1, 0, 1, 1, 1, 0, 1, 1, 1, 0, 1, 1, 1, 0, 1, 1, 1, 0, 1, 0, 1, 1, 1, 2 ],
                [ 2, 1, 0, 1, 0, 0, 0, 1, 0, 0, 1, 0, 0, 0, 1, 0, 0, 0, 1, 0, 0, 0, 0, 0, 1, 0, 0, 0, 1, 0, 0, 0, 1, 0, 0, 0, 0, 0, 1, 2 ],
                [ 2, 1, 0, 1, 1, 1, 0, 1, 0, 0, 1, 1, 1, 0, 1, 1, 1, 0, 1, 0, 1, 1, 1, 0, 1, 1, 1, 0, 1, 1, 1, 0, 1, 1, 1, 1, 1, 0, 1, 2 ],

                [ 2, 1, 0, 0, 0, 1, 0, 0, 0, 0, 0, 0, 1, 0, 0, 0, 1, 0, 0, 0, 0, 0, 1, 0, 0, 0, 1, 0, 0, 0, 0, 0, 1, 0, 0, 0, 1, 0, 1, 2 ],
                [ 2, 1, 1, 1, 0, 1, 1, 1, 1, 1, 1, 0, 1, 1, 1, 0, 1, 1, 1, 1, 1, 0, 1, 1, 1, 0, 1, 1, 1, 1, 1, 0, 1, 1, 1, 0, 1, 0, 1, 2 ],
                [ 2, 1, 0, 0, 0, 0, 0, 0, 0, 0, 1, 0, 0, 0, 1, 0, 0, 0, 0, 0, 1, 0, 0, 0, 1, 0, 0, 0, 0, 0, 1, 0, 0, 0, 1, 0, 1, 0, 1, 2 ],
                [ 2, 1, 0, 1, 1, 1, 1, 1, 1, 0, 1, 1, 1, 0, 1, 1, 1, 1, 1, 0, 1, 1, 1, 0, 1, 1, 1, 1, 1, 0, 1, 1, 1, 0, 1, 0, 1, 0, 1, 2 ],
                [ 2, 1, 0, 1, 0, 0, 0, 0, 1, 0, 0, 0, 1, 0, 0, 0, 0, 0, 1, 0, 0, 0, 1, 0, 0, 0, 0, 0, 1, 0, 0, 0, 1, 0, 0, 0, 1, 0, 1, 2 ],
                [ 2, 1, 0, 1, 0, 1, 1, 0, 1, 1, 1, 0, 1, 1, 1, 1, 1, 0, 1, 1, 1, 0, 1, 1, 1, 1, 1, 0, 1, 1, 1, 0, 1, 1, 1, 0, 1, 0, 1, 2 ],
                [ 2, 1, 0, 1, 0, 0, 1, 0, 0, 0, 1, 0, 0, 0, 0, 0, 1, 0, 0, 0, 1, 0, 0, 0, 0, 0, 1, 0, 0, 0, 1, 0, 0, 0, 1, 0, 0, 0, 1, 2 ],
                [ 2, 1, 0, 1, 1, 0, 1, 1, 1, 0, 1, 1, 1, 1, 1, 0, 1, 1, 1, 0, 1, 1, 1, 1, 1, 0, 1, 1, 1, 0, 1, 1, 1, 0, 1, 1, 1, 0, 1, 2 ],
                [ 2, 1, 0, 0, 0, 0, 0, 0, 1, 0, 0, 0, 0, 0, 1, 0, 0, 0, 1, 0, 0, 0, 0, 0, 1, 0, 0, 0, 1, 0, 0, 0, 0, 0, 0, 0, 1, 0, 1, 2 ],
                [ 2, 1, 1, 1, 1, 1, 1, 0, 1, 1, 1, 1, 1, 0, 1, 1, 1, 0, 1, 1, 1, 1, 1, 0, 1, 1, 1, 0, 1, 1, 1, 1, 1, 1, 1, 0, 1, 0, 1, 2 ],

                [ 2, 1, 0, 0, 0, 0, 1, 0, 0, 0, 0, 0, 1, 0, 0, 0, 1, 0, 0, 0, 0, 0, 1, 0, 0, 0, 1, 0, 0, 0, 0, 0, 1, 0, 0, 0, 1, 0, 1, 2 ],
                [ 2, 1, 0, 1, 1, 0, 1, 1, 1, 1, 1, 0, 1, 1, 1, 0, 1, 1, 1, 1, 1, 0, 1, 1, 1, 0, 1, 1, 1, 1, 1, 0, 1, 1, 1, 0, 1, 0, 1, 2 ],
                [ 2, 1, 0, 0, 1, 0, 0, 0, 0, 0, 1, 0, 0, 0, 1, 0, 0, 0, 0, 0, 1, 0, 0, 0, 1, 0, 0, 0, 0, 0, 1, 0, 0, 0, 1, 0, 0, 0, 1, 2 ],
                [ 2, 1, 1, 0, 1, 1, 1, 1, 1, 0, 1, 1, 1, 0, 1, 1, 1, 1, 1, 0, 1, 1, 1, 0, 1, 1, 1, 1, 1, 0, 1, 1, 1, 0, 1, 1, 1, 1, 1, 2 ],
                [ 2, 1, 0, 0, 0, 0, 0, 0, 1, 0, 0, 0, 0, 0, 0, 0, 0, 0, 1, 0, 0, 0, 0, 0, 0, 0, 0, 0, 1, 0, 0, 0, 0, 0, 0, 0, 0, 3, 1, 2 ],
                [ 2, 1, 1, 1, 1, 1, 1, 1, 1, 1, 1, 1, 1, 1, 1, 1, 1, 1, 1, 1, 1, 1, 1, 1, 1, 1, 1, 1, 1, 1, 1, 1, 1, 1, 1, 1, 1, 1, 1, 2 ],
                [ 2, 2, 2, 2, 2, 2, 2, 2, 2, 2, 2, 2, 2, 2, 2, 2, 2, 2, 2, 2, 2, 2, 2, 2, 2, 2, 2, 2, 2, 2, 2, 2, 2, 2, 2, 2, 2, 2, 2, 2 ]
            ]
        }
    ]
}
