{
    "tile_definition": {
        "0": "PATH",
        "1": "WALL",
        "2": "OUTER",
        "3": "GOAL",
        "4": "ITEM"
    },
    "stages": [
        {
            "metadata": {
                "id": 1,
                "name": "Stage 1: Rhythm Beginnings",
                "bpm": 93,
                "music": "Resources/Sounds/stage1.wav",
                "width": 10,
                "height": 8,
                "spawn_point": {
                    "x": 2,
                    "y": 2
                },
                "items": [
                    { "x": 6, "y": 4, "type": "time_freeze", "duration": 5.0 }
                ],
                "time_limit": 30,
                "monster_count": 5,
                "monster_types": ["stone_golem"]
            },
            "layers": [
                [ 2, 2, 2, 2, 2, 2, 2, 2, 2, 2 ],
                [ 2, 1, 1, 1, 1, 1, 1, 1, 1, 2 ],
                [ 2, 1, 0, 0, 0, 1, 0, 0, 1, 2 ],
                [ 2, 1, 0, 1, 0, 1, 0, 1, 1, 2 ],
                [ 2, 1, 0, 1, 0, 0, 4, 0, 1, 2 ],
                [ 2, 1, 0, 1, 1, 1, 1, 3, 1, 2 ],
                [ 2, 1, 1, 1, 1, 1, 1, 1, 1, 2 ],
                [ 2, 2, 2, 2, 2, 2, 2, 2, 2, 2 ]
            ]
        },
        {
            "metadata": {
                "id": 2,
                "name": "Stage 2: Double Tempo",
                "bpm": 121,
                "music": "Resources/Sounds/stage2.wav",
                "width": 10,
                "height": 8,
                "spawn_point": {
                    "x": 1,
                    "y": 1
                },
                "monster_spawns": [
                    {
                        "x": 7,
                        "y": 3
                    }
                ],
                "items": [
                    { "x": 3, "y": 3, "type": "invincibility" },
                    { "x": 6, "y": 3, "type": "darkness_down" },
                    { "x": 5, "y": 5, "type": "time_freeze", "duration": 5.0 }
                ],
                "time_limit": 45,
                "monster_count": 1,
                "monster_types": ["fire_golem"]
            },
            "layers": [
                [ 2, 2, 2, 2, 2, 2, 2, 2, 2, 2 ],
                [ 2, 0, 0, 0, 0, 0, 0, 0, 1, 2 ],
                [ 2, 1, 1, 1, 1, 1, 1, 0, 1, 2 ],
                [ 2, 1, 0, 4, 0, 0, 4, 0, 1, 2 ],
                [ 2, 1, 0, 1, 1, 1, 1, 1, 1, 2 ],
                [ 2, 1, 0, 0, 0, 4, 0, 3, 1, 2 ],
                [ 2, 1, 1, 1, 1, 1, 1, 1, 1, 2 ],
                [ 2, 2, 2, 2, 2, 2, 2, 2, 2, 2 ]
            ]
        },
        {
            "metadata": {
                "id": 3,
                "name": "Stage 3: Jungle Labyrinth",
                "bpm": 140,
                "music": "Resources/Sounds/stage3.wav",
                "width": 12,
                "height": 10,
                "spawn_point": {
                    "x": 2,
                    "y": 2
                },
                "items": [
                    { "x": 4, "y": 4, "type": "time_scale_down", "duration": 6.0 },
                    { "x": 6, "y": 6, "type": "invincibility" },
                    { "x": 5, "y": 8, "type": "darkness_down" }
                ],
                "time_limit": 60,
                "monster_count": 2,
                "monster_types": ["stone_golem", "fire_golem"]
            },

            "layers": [
                [ 2, 2, 2, 2, 2, 2, 2, 2, 2, 2, 2, 2 ],
                [ 2, 1, 1, 1, 1, 1, 1, 1, 1, 1, 1, 2 ],
                [ 2, 1, 0, 0, 0, 1, 0, 0, 0, 0, 1, 2 ],
                [ 2, 1, 0, 1, 0, 1, 0, 1, 1, 0, 1, 2 ],
                [ 2, 1, 0, 1, 4, 0, 0, 1, 0, 0, 1, 2 ],
                [ 2, 1, 0, 1, 1, 1, 0, 1, 0, 1, 1, 2 ],
                [ 2, 1, 0, 0, 0, 1, 4, 0, 0, 0, 1, 2 ],
                [ 2, 1, 1, 1, 0, 1, 1, 1, 1, 0, 1, 2 ],
                [ 2, 1, 0, 0, 0, 4, 0, 0, 1, 3, 1, 2 ],
                [ 2, 2, 2, 2, 2, 2, 2, 2, 2, 2, 2, 2 ]
            ]
        },
        {
            "metadata": {
                "id": 4,
                "name": "Stage 4: Jungle Echo Maze",
                "bpm": 160,
                "music": "Resources/Sounds/stage4.wav",
                "width": 77,
                "height": 24,
                "spawn_point": {
                    "x": 8,
                    "y": 2
                },
                "items": [
                    { "x": 18, "y": 2, "type": "time_freeze", "duration": 5.0 },
                    { "x": 23, "y": 6, "type": "invincibility" },
                    { "x": 35, "y": 11, "type": "time_scale_down", "duration": 8.0 },
                    { "x": 53, "y": 10, "type": "darkness_down" },
                    { "x": 60, "y": 20, "type": "time_scale_up", "duration": 6.0 }
                ],
                "time_limit": 120,
                "monster_count": 5
            },

            "layers": [
                [ 2, 2, 2, 2, 2, 2, 2, 2, 2, 2, 2, 2, 2, 2, 2, 2, 2, 2, 2, 2, 2, 2, 2, 2, 2, 2, 2, 2, 2, 2, 2, 2, 2, 2, 2, 2, 2, 2, 2, 2, 2, 2, 2, 2, 2, 2, 2, 2, 2, 2, 2, 2, 2, 2, 2, 2, 2, 2, 2, 2, 2, 2, 2, 2, 2, 2, 2, 2, 2, 2, 2, 2, 2, 2, 2, 2, 2 ],
                [ 2, 2, 2, 2, 2, 2, 2, 1, 1, 1, 1, 1, 1, 1, 1, 1, 1, 1, 1, 1, 1, 1, 1, 1, 1, 2, 2, 2, 2, 2, 1, 1, 1, 1, 1, 1, 1, 1, 1, 1, 1, 1, 1, 1, 1, 1, 1, 1, 1, 1, 1, 1, 1, 1, 1, 1, 1, 1, 1, 1, 1, 1, 1, 1, 1, 1, 1, 1, 1, 1, 1, 2, 2, 2, 2, 2, 2 ],
                [ 2, 2, 2, 2, 2, 2, 2, 1, 0, 0, 0, 0, 0, 0, 0, 0, 0, 0, 4, 0, 0, 0, 0, 0, 1, 2, 2, 2, 2, 2, 1, 0, 0, 0, 0, 0, 0, 0, 0, 0, 0, 0, 0, 0, 0, 0, 0, 0, 0, 0, 0, 0, 0, 0, 0, 0, 0, 0, 0, 0, 0, 0, 0, 0, 0, 0, 0, 0, 0, 0, 1, 2, 2, 2, 2, 2, 2 ],
                [ 2, 2, 2, 2, 2, 2, 2, 1, 1, 1, 1, 1, 1, 1, 1, 1, 0, 0, 0, 0, 1, 1, 1, 1, 1, 2, 2, 2, 2, 2, 1, 1, 1, 1, 1, 1, 1, 1, 1, 1, 1, 1, 1, 1, 1, 1, 0, 0, 0, 1, 1, 1, 1, 1, 1, 1, 1, 1, 1, 1, 1, 1, 1, 1, 1, 1, 1, 0, 0, 0, 1, 2, 2, 2, 2, 2, 2 ],
                [ 2, 2, 2, 2, 2, 2, 2, 2, 2, 2, 2, 2, 2, 2, 2, 1, 0, 0, 0, 0, 1, 2, 2, 2, 2, 2, 2, 2, 2, 2, 2, 2, 2, 2, 2, 2, 2, 2, 2, 2, 2, 2, 2, 2, 2, 1, 0, 0, 0, 1, 2, 2, 2, 2, 2, 2, 2, 2, 2, 2, 2, 2, 2, 2, 2, 2, 1, 0, 0, 0, 1, 2, 2, 2, 2, 2, 2 ],
                [ 2, 2, 2, 2, 2, 1, 1, 1, 1, 1, 1, 1, 1, 1, 1, 1, 0, 0, 0, 0, 1, 1, 1, 1, 1, 1, 1, 1, 2, 2, 2, 2, 2, 1, 1, 1, 1, 1, 1, 2, 2, 2, 2, 2, 2, 1, 0, 0, 0, 1, 1, 1, 1, 1, 1, 1, 1, 1, 1, 1, 1, 2, 2, 2, 2, 2, 1, 0, 0, 0, 1, 2, 2, 2, 2, 2, 2 ],
                [ 2, 2, 2, 2, 2, 1, 0, 0, 0, 0, 0, 0, 0, 0, 0, 0, 0, 0, 0, 0, 0, 0, 0, 4, 0, 0, 0, 1, 2, 2, 1, 1, 1, 1, 0, 0, 0, 1, 1, 1, 1, 1, 1, 1, 1, 1, 0, 0, 0, 0, 0, 0, 0, 0, 0, 0, 0, 0, 0, 0, 1, 2, 2, 1, 1, 1, 1, 0, 0, 0, 1, 2, 2, 2, 2, 2, 2 ],
                [ 2, 2, 2, 2, 2, 1, 0, 0, 0, 0, 0, 0, 0, 0, 0, 0, 0, 0, 0, 0, 0, 0, 0, 0, 0, 0, 0, 1, 2, 2, 1, 0, 0, 0, 0, 0, 0, 0, 0, 0, 0, 0, 0, 0, 0, 0, 0, 1, 1, 1, 1, 1, 1, 1, 1, 1, 1, 0, 0, 0, 1, 2, 2, 1, 0, 0, 0, 0, 0, 0, 1, 2, 2, 2, 2, 2, 2 ],
                [ 2, 2, 2, 2, 2, 1, 1, 1, 1, 1, 1, 1, 0, 0, 0, 0, 1, 1, 1, 1, 1, 0, 0, 0, 0, 0, 0, 1, 2, 2, 1, 1, 1, 1, 0, 0, 0, 1, 1, 1, 1, 1, 1, 1, 1, 1, 1, 1, 2, 2, 2, 2, 2, 2, 2, 2, 1, 0, 0, 0, 1, 2, 2, 1, 1, 1, 1, 1, 1, 1, 1, 2, 2, 2, 2, 2, 2 ],
                [ 2, 2, 2, 2, 2, 2, 2, 2, 2, 2, 2, 1, 0, 0, 0, 0, 1, 2, 2, 2, 1, 0, 0, 0, 0, 0, 0, 1, 2, 2, 2, 2, 2, 1, 0, 0, 0, 1, 2, 2, 2, 2, 2, 2, 2, 2, 2, 2, 2, 2, 2, 1, 1, 1, 1, 1, 1, 0, 0, 0, 1, 2, 2, 2, 2, 2, 2, 2, 2, 2, 2, 2, 2, 2, 2, 2, 2 ],
                [ 2, 2, 2, 2, 2, 2, 2, 2, 2, 2, 2, 1, 0, 0, 0, 0, 1, 2, 2, 2, 1, 0, 0, 0, 0, 0, 0, 1, 2, 2, 2, 2, 2, 1, 0, 0, 0, 1, 2, 2, 1, 1, 1, 1, 1, 1, 1, 1, 1, 1, 1, 1, 0, 4, 0, 0, 0, 0, 0, 0, 1, 2, 2, 2, 2, 2, 2, 2, 2, 2, 2, 2, 2, 2, 2, 2, 2 ],
                [ 2, 2, 2, 2, 2, 1, 1, 1, 1, 1, 1, 1, 0, 0, 0, 0, 1, 2, 2, 2, 1, 0, 0, 0, 0, 0, 0, 1, 1, 1, 1, 1, 1, 1, 0, 4, 0, 1, 2, 2, 1, 0, 0, 0, 0, 0, 0, 0, 0, 0, 0, 0, 0, 0, 0, 0, 1, 1, 1, 1, 1, 2, 2, 2, 2, 2, 2, 2, 2, 2, 2, 2, 2, 2, 2, 2, 2 ],
                [ 2, 2, 2, 2, 2, 1, 0, 0, 0, 0, 0, 0, 0, 0, 0, 0, 1, 2, 2, 2, 1, 0, 0, 0, 0, 0, 0, 0, 0, 0, 0, 0, 0, 0, 0, 0, 0, 1, 2, 2, 1, 0, 0, 0, 0, 0, 0, 0, 0, 0, 0, 0, 0, 0, 0, 0, 1, 2, 2, 2, 2, 2, 2, 2, 2, 2, 2, 2, 2, 2, 2, 2, 2, 2, 2, 2, 2 ],
                [ 2, 2, 2, 2, 2, 1, 0, 0, 0, 0, 0, 0, 0, 0, 0, 0, 1, 2, 2, 2, 1, 0, 0, 0, 0, 0, 0, 1, 1, 1, 1, 1, 1, 1, 1, 1, 1, 1, 2, 2, 1, 0, 0, 0, 0, 1, 1, 1, 1, 1, 1, 1, 0, 0, 0, 0, 1, 1, 1, 1, 1, 1, 1, 1, 1, 1, 1, 1, 1, 1, 1, 1, 2, 2, 2, 2, 2 ],
                [ 2, 2, 2, 2, 2, 1, 0, 0, 0, 0, 0, 0, 0, 0, 0, 0, 1, 2, 2, 2, 1, 0, 0, 0, 0, 0, 0, 1, 2, 2, 2, 2, 2, 2, 2, 2, 2, 2, 2, 2, 1, 0, 0, 0, 0, 1, 2, 2, 2, 2, 2, 1, 0, 0, 0, 0, 0, 0, 0, 0, 0, 0, 0, 0, 0, 0, 0, 0, 0, 0, 0, 1, 2, 2, 2, 2, 2 ],
                [ 2, 2, 2, 2, 2, 1, 1, 1, 1, 1, 1, 1, 1, 1, 1, 1, 1, 2, 2, 2, 1, 0, 0, 0, 0, 0, 0, 1, 2, 2, 2, 2, 2, 2, 2, 2, 2, 2, 2, 2, 1, 0, 0, 0, 0, 1, 2, 2, 2, 2, 2, 1, 0, 0, 0, 0, 0, 0, 0, 0, 0, 0, 0, 0, 0, 0, 0, 0, 0, 0, 0, 1, 2, 2, 2, 2, 2 ],
                [ 2, 2, 2, 2, 2, 2, 2, 2, 2, 2, 2, 2, 2, 2, 2, 2, 2, 2, 2, 2, 1, 0, 0, 0, 0, 0, 0, 1, 2, 2, 2, 2, 2, 2, 2, 2, 2, 2, 2, 2, 1, 0, 0, 0, 0, 1, 2, 2, 2, 2, 2, 1, 1, 1, 1, 1, 1, 1, 1, 1, 1, 1, 1, 1, 1, 1, 1, 0, 0, 0, 0, 1, 2, 2, 2, 2, 2 ],
                [ 2, 2, 2, 2, 2, 2, 2, 2, 2, 2, 1, 1, 1, 1, 1, 1, 1, 1, 1, 1, 1, 0, 0, 0, 0, 0, 0, 1, 1, 1, 1, 1, 1, 1, 1, 1, 1, 1, 2, 2, 1, 0, 0, 0, 0, 1, 2, 2, 2, 2, 2, 2, 2, 2, 2, 2, 2, 2, 2, 2, 2, 2, 2, 2, 2, 2, 1, 0, 0, 0, 0, 1, 2, 2, 2, 2, 2 ],
                [ 2, 2, 2, 2, 2, 2, 2, 2, 2, 2, 1, 0, 0, 0, 0, 0, 0, 0, 0, 0, 0, 0, 0, 0, 0, 0, 0, 0, 0, 0, 0, 0, 0, 0, 0, 0, 0, 1, 2, 2, 1, 1, 1, 1, 1, 1, 2, 2, 2, 2, 2, 2, 2, 2, 2, 2, 2, 2, 2, 2, 2, 2, 2, 2, 2, 2, 1, 0, 0, 0, 0, 1, 2, 2, 2, 2, 2 ],
                [ 2, 2, 2, 2, 2, 2, 2, 2, 2, 2, 1, 0, 0, 0, 0, 0, 0, 0, 0, 0, 0, 0, 0, 0, 0, 0, 0, 0, 0, 0, 0, 0, 0, 0, 0, 0, 0, 1, 2, 2, 2, 2, 2, 2, 2, 2, 2, 2, 1, 1, 1, 1, 1, 1, 1, 1, 1, 1, 1, 1, 1, 1, 1, 1, 1, 1, 1, 0, 0, 0, 0, 1, 2, 2, 2, 2, 2 ],
                [ 2, 2, 2, 2, 2, 2, 2, 2, 2, 2, 1, 0, 0, 0, 0, 0, 0, 0, 0, 0, 0, 0, 0, 0, 0, 0, 0, 0, 0, 0, 0, 0, 0, 0, 0, 0, 0, 1, 2, 2, 2, 2, 2, 2, 2, 2, 2, 2, 1, 0, 0, 0, 0, 0, 0, 0, 0, 0, 0, 0, 4, 0, 0, 0, 0, 0, 0, 0, 0, 0, 0, 1, 2, 2, 2, 2, 2 ],
                [ 2, 2, 2, 2, 2, 2, 2, 2, 2, 2, 1, 0, 0, 0, 0, 0, 0, 0, 0, 0, 0, 0, 0, 0, 0, 0, 0, 0, 0, 0, 0, 0, 0, 0, 0, 0, 0, 1, 2, 2, 2, 2, 2, 2, 2, 2, 2, 2, 1, 3, 0, 0, 0, 0, 0, 0, 0, 0, 0, 0, 0, 0, 0, 0, 0, 0, 0, 0, 0, 0, 0, 1, 2, 2, 2, 2, 2 ],
                [ 2, 2, 2, 2, 2, 2, 2, 2, 2, 2, 1, 1, 1, 1, 1, 1, 1, 1, 1, 1, 1, 1, 1, 1, 1, 1, 1, 1, 1, 1, 1, 1, 1, 1, 1, 1, 1, 1, 2, 2, 2, 2, 2, 2, 2, 2, 2, 2, 1, 1, 1, 1, 1, 1, 1, 1, 1, 1, 1, 1, 1, 1, 1, 1, 1, 1, 1, 1, 1, 1, 1, 1, 2, 2, 2, 2, 2 ],
                [ 2, 2, 2, 2, 2, 2, 2, 2, 2, 2, 2, 2, 2, 2, 2, 2, 2, 2, 2, 2, 2, 2, 2, 2, 2, 2, 2, 2, 2, 2, 2, 2, 2, 2, 2, 2, 2, 2, 2, 2, 2, 2, 2, 2, 2, 2, 2, 2, 2, 2, 2, 2, 2, 2, 2, 2, 2, 2, 2, 2, 2, 2, 2, 2, 2, 2, 2, 2, 2, 2, 2, 2, 2, 2, 2, 2, 2 ]
            ]
        }
    ]
}
