{
  "tile_definition": {
    "0": "PATH",
    "1": "WALL",
    "2": "OUTER",
    "3": "GOAL"
  },
"stages": [
    {
      "metadata": {
        "id": 1,
        "name": "Stage 1: Rhythm Beginnings",
        "width": 10,
        "height": 8,
        "spawn_point": { "x": 2, "y": 2 },
        "bpm": 60
      },
      "layers": [
        [2, 2, 2, 2, 2, 2, 2, 2, 2, 2],
        [2, 1, 1, 1, 1, 1, 1, 1, 1, 2],
        [2, 1, 0, 0, 0, 1, 0, 0, 1, 2],
        [2, 1, 0, 1, 0, 1, 0, 1, 1, 2],
        [2, 1, 0, 1, 0, 0, 0, 0, 1, 2],
        [2, 1, 0, 1, 1, 1, 1, 3, 1, 2],
        [2, 1, 1, 1, 1, 1, 1, 1, 1, 2],
        [2, 2, 2, 2, 2, 2, 2, 2, 2, 2]
      ]
    },
    {
      "metadata": {
        "id": 2,
        "name": "Stage 2: Double Tempo",
        "width": 10,
        "height": 8,
        "spawn_point": { "x": 1, "y": 1 }
      },
      "layers": [
        [2, 2, 2, 2, 2, 2, 2, 2, 2, 2],
        [2, 0, 0, 0, 0, 0, 0, 0, 1, 2],
        [2, 1, 1, 1, 1, 1, 1, 0, 1, 2],
        [2, 1, 0, 0, 0, 0, 0, 0, 1, 2],
        [2, 1, 0, 1, 1, 1, 1, 1, 1, 2],
        [2, 1, 0, 0, 0, 0, 0, 3, 1, 2],
        [2, 1, 1, 1, 1, 1, 1, 1, 1, 2],
        [2, 2, 2, 2, 2, 2, 2, 2, 2, 2]
      ]
    }
  ]
}